#.....######################################################
#...........#.....#........................................#
#...........#.....#........................................#
#...........#.....#........................................#
#...........#.....#........................................#
#...........#.....#........................................#
#######.....#.....#.....#############....##....#############
#.....#.....#...........#..........##....##....##..........#
#.....#.....#...........#..........##....##....##..........#
#.....#.....#...........#..........##....##....##..........#
#.....#.....#...........#..........##....##....##..........#
#.....#.....#...........#..........##....##....##..........#
#.....#.....#############....##....########....##....##....#
#.....#...........#..........##..........##..........##....#
#.....#...........#..........##..........##..........##....#
#.....#...........#..........##..........##..........##....#
#.....#...........#..........##..........##..........##....#
#.....#...........#..........##..........##..........##....#
#.....#######.....#.....#############....##############....#
#.................#..........##....##..........##..........#
#.................#..........##....##..........##..........#
#.................#..........##....##..........##..........#
#.................#..........##....##..........##..........#
#.................#..........##....##..........##..........#
#.....#############.....#....##....########....##....##....#
#.................#.....#....##..........##..........##....#
#.................#.....#....##..........##..........##....#
#.................#.....#....##..........##..........##....#
#.................#.....#....##..........##..........##....#
#############.....#######....##.....###################....#
#############.....#######....##.....###################....#
#...........#.....#..........##......................##....#
#...........#.....#..........##......................##....#
#...........#.....#..........##......................##....#
#...........#.....#..........##......................##....#
#######.....#.....#.....############............#######....#
#######.....#.....#.....#############....##.....######.....#
#...........#.....#.....#..........##....##................#
#...........#.....#.....#..........##....##................#
#...........#.....#.....#..........##....##................#
#...........#.....#.....#..........##....##................#
#.....#######.....#.....#..........########.....############
#.....#######.....#.....#....##.....#######.....############
#.....#...........#..........##..........##..........##....#
#.....#...........#..........##..........##..........##....#
#.....#...........#..........##..........##..........##....#
#.....#...........#..........##..........##..........##....#
#.....#.....#############....#######.....#######.....##....#
#.....#.....#############....#######.....########....##....#
#...........#...........#....##..........##....##....##....#
#...........#...........#....##..........##....##....##....#
#...........#...........#....##..........##....##....##....#
#...........#...........#....##..........##....##....##....#
#.....#######.....#.....#######.....#######....##....##....#
#.....#######.....#.....######.....#######.................#
#.................#................##......................#
#.................#................##......................#
#.................#................##......................#
#.................#................##......................#
#######################################################....#