XOOOOOXXXXXXXXXXXXXXXXXXXXXXXXXXXXXXXXXXXXXXXXXXXXXXXXXXXXXX
XOOOOOOOOOOOXOOOOOXOOOOOOOOOOOOOOOOOOOOOOOOOOOOOOOOOOOOOOOOX
XOOOOOOOOOOOXOOOOOXOOOOOOOOOOOOOOOOOOOOOOOOOOOOOOOOOOOOOOOOX
XOOOOOOOOOOOXOOOOOXOOOOOOOOOOOOOOOOOOOOOOOOOOOOOOOOOOOOOOOOX
XOOOOOOOOOOOXOOOOOXOOOOOOOOOOOOOOOOOOOOOOOOOOOOOOOOOOOOOOOOX
XOOOOOOOOOOOXOOOOOXOOOOOOOOOOOOOOOOOOOOOOOOOOOOOOOOOOOOOOOOX
XXXXXXXOOOOOXOOOOOXOOOOOXXXXXXXXXXXXXOOOOXXOOOOXXXXXXXXXXXXX
XOOOOOXOOOOOXOOOOOOOOOOOXOOOOOOOOOOXXOOOOXXOOOOXXOOOOOOOOOOX
XOOOOOXOOOOOXOOOOOOOOOOOXOOOOOOOOOOXXOOOOXXOOOOXXOOOOOOOOOOX
XOOOOOXOOOOOXOOOOOOOOOOOXOOOOOOOOOOXXOOOOXXOOOOXXOOOOOOOOOOX
XOOOOOXOOOOOXOOOOOOOOOOOXOOOOOOOOOOXXOOOOXXOOOOXXOOOOOOOOOOX
XOOOOOXOOOOOXOOOOOOOOOOOXOOOOOOOOOOXXOOOOXXOOOOXXOOOOOOOOOOX
XOOOOOXOOOOOXXXXXXXXXXXXXOOOOXXOOOOXXXXXXXXOOOOXXOOOOXXOOOOX
XOOOOOXOOOOOOOOOOOXOOOOOOOOOOXXOOOOOOOOOOXXOOOOOOOOOOXXOOOOX
XOOOOOXOOOOOOOOOOOXOOOOOOOOOOXXOOOOOOOOOOXXOOOOOOOOOOXXOOOOX
XOOOOOXOOOOOOOOOOOXOOOOOOOOOOXXOOOOOOOOOOXXOOOOOOOOOOXXOOOOX
XOOOOOXOOOOOOOOOOOXOOOOOOOOOOXXOOOOOOOOOOXXOOOOOOOOOOXXOOOOX
XOOOOOXOOOOOOOOOOOXOOOOOOOOOOXXOOOOOOOOOOXXOOOOOOOOOOXXOOOOX
XOOOOOXXXXXXXOOOOOXOOOOOXXXXXXXXXXXXXOOOOXXXXXXXXXXXXXXOOOOX
XOOOOOOOOOOOOOOOOOXOOOOOOOOOOXXOOOOXXOOOOOOOOOOXXOOOOOOOOOOX
XOOOOOOOOOOOOOOOOOXOOOOOOOOOOXXOOOOXXOOOOOOOOOOXXOOOOOOOOOOX
XOOOOOOOOOOOOOOOOOXOOOOOOOOOOXXOOOOXXOOOOOOOOOOXXOOOOOOOOOOX
XOOOOOOOOOOOOOOOOOXOOOOOOOOOOXXOOOOXXOOOOOOOOOOXXOOOOOOOOOOX
XOOOOOOOOOOOOOOOOOXOOOOOOOOOOXXOOOOXXOOOOOOOOOOXXOOOOOOOOOOX
XOOOOOXXXXXXXXXXXXXOOOOOXOOOOXXOOOOXXXXXXXXOOOOXXOOOOXXOOOOX
XOOOOOOOOOOOOOOOOOXOOOOOXOOOOXXOOOOOOOOOOXXOOOOOOOOOOXXOOOOX
XOOOOOOOOOOOOOOOOOXOOOOOXOOOOXXOOOOOOOOOOXXOOOOOOOOOOXXOOOOX
XOOOOOOOOOOOOOOOOOXOOOOOXOOOOXXOOOOOOOOOOXXOOOOOOOOOOXXOOOOX
XOOOOOOOOOOOOOOOOOXOOOOOXOOOOXXOOOOOOOOOOXXOOOOOOOOOOXXOOOOX
XXXXXXXXXXXXXOOOOOXXXXXXXOOOOXXOOOOOXXXXXXXXXXXXXXXXXXXOOOOX
XXXXXXXXXXXXXOOOOOXXXXXXXOOOOXXOOOOOXXXXXXXXXXXXXXXXXXXOOOOX
XOOOOOOOOOOOXOOOOOXOOOOOOOOOOXXOOOOOOOOOOOOOOOOOOOOOOXXOOOOX
XOOOOOOOOOOOXOOOOOXOOOOOOOOOOXXOOOOOOOOOOOOOOOOOOOOOOXXOOOOX
XOOOOOOOOOOOXOOOOOXOOOOOOOOOOXXOOOOOOOOOOOOOOOOOOOOOOXXOOOOX
XOOOOOOOOOOOXOOOOOXOOOOOOOOOOXXOOOOOOOOOOOOOOOOOOOOOOXXOOOOX
XXXXXXXOOOOOXOOOOOXOOOOOXXXXXXXXXXXXOOOOOOOOOOOOXXXXXXXOOOOX
XXXXXXXOOOOOXOOOOOXOOOOOXXXXXXXXXXXXXOOOOXXOOOOOXXXXXXOOOOOX
XOOOOOOOOOOOXOOOOOXOOOOOXOOOOOOOOOOXXOOOOXXOOOOOOOOOOOOOOOOX
XOOOOOOOOOOOXOOOOOXOOOOOXOOOOOOOOOOXXOOOOXXOOOOOOOOOOOOOOOOX
XOOOOOOOOOOOXOOOOOXOOOOOXOOOOOOOOOOXXOOOOXXOOOOOOOOOOOOOOOOX
XOOOOOOOOOOOXOOOOOXOOOOOXOOOOOOOOOOXXOOOOXXOOOOOOOOOOOOOOOOX
XOOOOOXXXXXXXOOOOOXOOOOOXOOOOOOOOOOXXXXXXXXOOOOOXXXXXXXXXXXX
XOOOOOXXXXXXXOOOOOXOOOOOXOOOOXXOOOOOXXXXXXXOOOOOXXXXXXXXXXXX
XOOOOOXOOOOOOOOOOOXOOOOOOOOOOXXOOOOOOOOOOXXOOOOOOOOOOXXOOOOX
XOOOOOXOOOOOOOOOOOXOOOOOOOOOOXXOOOOOOOOOOXXOOOOOOOOOOXXOOOOX
XOOOOOXOOOOOOOOOOOXOOOOOOOOOOXXOOOOOOOOOOXXOOOOOOOOOOXXOOOOX
XOOOOOXOOOOOOOOOOOXOOOOOOOOOOXXOOOOOOOOOOXXOOOOOOOOOOXXOOOOX
XOOOOOXOOOOOXXXXXXXXXXXXXOOOOXXXXXXXOOOOOXXXXXXXOOOOOXXOOOOX
XOOOOOXOOOOOXXXXXXXXXXXXXOOOOXXXXXXXOOOOOXXXXXXXXOOOOXXOOOOX
XOOOOOOOOOOOXOOOOOOOOOOOXOOOOXXOOOOOOOOOOXXOOOOXXOOOOXXOOOOX
XOOOOOOOOOOOXOOOOOOOOOOOXOOOOXXOOOOOOOOOOXXOOOOXXOOOOXXOOOOX
XOOOOOOOOOOOXOOOOOOOOOOOXOOOOXXOOOOOOOOOOXXOOOOXXOOOOXXOOOOX
XOOOOOOOOOOOXOOOOOOOOOOOXOOOOXXOOOOOOOOOOXXOOOOXXOOOOXXOOOOX
XOOOOOXXXXXXXOOOOOXOOOOOXXXXXXXOOOOOXXXXXXXOOOOXXOOOOXXOOOOX
XOOOOOXXXXXXXOOOOOXOOOOOXXXXXXOOOOOXXXXXXXOOOOOOOOOOOOOOOOOX
XOOOOOOOOOOOOOOOOOXOOOOOOOOOOOOOOOOXXOOOOOOOOOOOOOOOOOOOOOOX
XOOOOOOOOOOOOOOOOOXOOOOOOOOOOOOOOOOXXOOOOOOOOOOOOOOOOOOOOOOX
XOOOOOOOOOOOOOOOOOXOOOOOOOOOOOOOOOOXXOOOOOOOOOOOOOOOOOOOOOOX
XOOOOOOOOOOOOOOOOOXOOOOOOOOOOOOOOOOXXOOOOOOOOOOOOOOOOOOOOOOX
XXXXXXXXXXXXXXXXXXXXXXXXXXXXXXXXXXXXXXXXXXXXXXXXXXXXXXXOOOOX